PX=22
PY=11
888888888884464464644464
800000000084000000000004
803000000884000000000006
800300000000000000000006
803300000884000000000004
800000000084000006660646
888808888884444446000006
777707777090808084040606
770000007808080886000006
700000000000000086000004
700000000000000086060606
770000007800080886460666
777707777884068483330333
222202222464006063000003
220000022400000043000003
200000002400000043000003
100000001444446063300033
200000002221222660050505
220000022200022050500055
200000002000002505050505
100000000000000000000005
200000002000002505050505
220000022200022050500055
222212222221222555555555